8 9
  ##### 
###   # 
#.@$  # 
### $.# 
#.##$ # 
# # . ##
#$ *$$.#
#   .  #
########
